-.-.-.-.-.-.-.-.-.-.-.-.-.-.-.-.-.-.-.-.-.-.-.-.
-. .x.h. . . . . . . . . . . . . . . . . . . .-.
-. . . . . . . .-. . . . . . . . . . . . . . .-.
-. . . . .D. . . . . . . . . . . . . . . . . .-.
-. . . . . . . . . . . . .h. . . . . . . . . .-.
-. . . . . . . . . . . . . . .x. . . . . . . .-.
-. . . . .H. . . . . . . . . . . . . . . . . .-.
-. . . . . . . . . . . . . . . . . . . . . . .-.
-. . . . . . . . . . . . . . . . . . . . . . .-.
-.-.-.-.-.-.-.-.-.-.-.-.-.-.-.-.-.-.-.-.-.-.-.-.