-.-.-.-.-.-.-.-.-.-.-.-.-.-.-.-.-.-.-.-.-.-.-.-.
-. . . . . . . . . . . . . . . . . . . . . . .-.
-. .x. . . . . .-. . . . . . . . . .h. . . . .-.
-. . . . .D. . . . . . . . . . . . . . . . . .-.
-. . . . . . . . . . . . .h. . . . . . . . . .-.
-. . . . . . . . . . . . . . . . . . . . . . .-.
-. . . . .H. . . . . . . . . . . . . . . . . .-.
-. . . . . . . . . . . . . . . .x. . . . . . .-.
-. . . . . . . . . . . . . . . . . . . . . . .-.
-.-.-.-.-.-.-.-.-.-.-.-.-.-.-.-.-.-.-.-.-.-.-.-.